CFT	= "countries/Chinese Fengtian Clique.txt"
CZL	= "countries/Chinese Zhili Clique.txt"
CAH	= "countries/Chinese Anhui Clique.txt"
CGX	= "countries/Chinese Guangxi Clique.txt"
CYN	= "countries/Chinese Yunnan Clique.txt"
CSC	= "countries/Chinese Sichuan Clique.txt"
CSX	= "countries/Chinese Shanxi Clique.txt"
CXJ	= "countries/Chinese Xinjiang Clique.txt"
CGD	= "countries/Chinese Guangdong Clique.txt"
CHN	= "countries/Chinese Hunan Clique.txt"
CGZ	= "countries/Chinese Guizhou Clique.txt"
CJG	= "countries/Chinese Shaanxi Jingguo Clique.txt"
CEX	= "countries/Chinese Hubei Jingguo Clique.txt"
CYX	= "countries/Chinese Zhensong Clique.txt"
CSD	= "countries/Chinese Shandong Clique.txt"
CSA	= "countries/Chinese Shaanxi Clique.txt"
CQY	= "countries/Chinese Qiongya Clique.txt"
CHE	= "countries/Chinese Henan Clique.txt"
CFJ	= "countries/Chinese Fujian Clique.txt"
CCH	= "countries/Chinese Chahar Clique.txt"
CRH	= "countries/Chinese Rehe Clique.txt"
CJX	= "countries/Chinese Jiangxi Clique.txt"
CJS	= "countries/Chinese Jiangsu Clique.txt"
CHB	= "countries/Chinese Hubei Clique.txt"
CZJ	= "countries/Chinese Zhejiang Clique.txt"
CHJ	= "countries/Chinese Heilongjiang Clique.txt"
CJL	= "countries/Chinese Jilin Clique.txt"
CGS	= "countries/Chinese Gansu Clique.txt"
CNX	= "countries/Chinese Ningxia Clique.txt"
CQH	= "countries/Chinese Qinghai Clique.txt"
CSY	= "countries/Chinese Suiyuan Clique.txt"
CXK	= "countries/Chinese Xikang Clique.txt"
CXZ	= "countries/Chinese Xizang Clique.txt"
CBJ	= "countries/Chinese Beijing City.txt"
CSH	= "countries/Chinese Shanghai City.txt"
CTW	= "countries/Chinese Taiwan State.txt"
CLS	= "countries/Chinese Lvshun State.txt"
CXG	= "countries/Chinese Xianggang State.txt"
CAO	= "countries/Chinese Aomen State.txt"
CWH	= "countries/Chinese Weihaiwei State.txt"

MON	= "countries/Mongolia.txt"
TAN	= "countries/Tannu Tuva.txt"
KOR	= "countries/Korea.txt"
JAP	= "countries/Japan.txt"
INC	= "countries/Indochina.txt"
BUR	= "countries/Burma.txt"
SIA	= "countries/Siam.txt"
PHL	= "countries/Philippines.txt"
RYU	= "countries/Ryukyu.txt"
SAK	= "countries/Sakhalin.txt"
IND	= "countries/India.txt"
PAK	= "countries/Pakistan.txt"
BNG	= "countries/Bengal.txt"
SRI	= "countries/Sri Lanka.txt"
MLD	= "countries/Maldives.txt"
NEP	= "countries/Nepal.txt"
BHU	= "countries/Bhutan.txt"
GOA	= "countries/Goa.txt"
PON	= "countries/Pondichery.txt"
MAL	= "countries/Malaysia.txt"
SIN	= "countries/Singapore.txt"
BRU	= "countries/Brunei.txt"
SAB	= "countries/Sabah.txt"
SWK	= "countries/Sarawak.txt"

PRI	= "countries/Priamurye.txt"
AMU	= "countries/Amur.txt"
TUG	= "countries/Tungus.txt"
KAM	= "countries/Kamchatka.txt"
CHU	= "countries/Chukotka.txt"
ZAB	= "countries/Zabaykalye.txt"
YAK	= "countries/Yakutia.txt"
ORI	= "countries/Oriot.txt"
SEM	= "countries/Semirechye.txt"
ALA	= "countries/Alash.txt"
TUK	= "countries/Turkestan.txt"
BAS	= "countries/Basmachi.txt"
BUK	= "countries/Bukhara.txt"
KHI	= "countries/Khiva.txt"
TRA	= "countries/Transcaspia.txt"
URA	= "countries/Ural.txt"
MNC	= "countries/Mountaineers.txt"
KUB	= "countries/Kuban.txt"
DON	= "countries/Don.txt"

AZR	= "countries/Azerbaijan.txt"
ARM	= "countries/Armenia.txt"
GEO	= "countries/Georgia.txt"
UKR	= "countries/Ukraine.txt"
BLR	= "countries/Belarus.txt"
POL	= "countries/Poland.txt"

RRU	= "countries/Red Russia.txt"
WRU	= "countries/White Russia.txt"
NRU	= "countries/Northern Russia.txt"
SRU	= "countries/Southern Russia.txt"

GBR	= "countries/Britain.txt"
FRA	= "countries/France.txt"
USA	= "countries/America.txt"
GER	= "countries/Germany.txt"
ITA	= "countries/Italy.txt"
RUS	= "countries/Russia.txt"

KIA = "countries/Korean Army.txt"

ZZZ	= "countries/Default.txt"
